이번주 목요일, 금요일 노트북들고 센터가서 반영 작업예정
개인상담 메인페이지 작업 시작

분류관리
대분류 등록후 소분류 등록시 대분류 한번 클릭하고난 후에 등록가능하게 개선할것

메인메뉴 - 운영자,내담자관리,상담내역서,보고서,집단상담,실적,검색,게시판

성별 - 남,여
나이 - 60대,70대,80대,90대 이상,60대 미만
전공 - 상담심리,임상심리,심리,기타심리,교육,사회복지,기타
종교 - 무교,기독교,천주교,불교,원불교,기타
인정자격증 - 상담심리사,임상심리사,정신보건임상심리사,정신보건사회복지사,사회복지사
기타자격 - 청소년상담사,자살예방QPR Instructor,노인전문상담사,노인집단상담사,가정폭력전문상담원,
         성폭력전문상담원,미술치료사,기타
학력 - 무학, 초졸, 중졸, 고졸, 전문대졸, 대졸, 석사, 박사, 문맹, 읽기만 가능, 불완전 일고 쓰기 가능, 완전 읽고 쓰기 가능
실무경력 - 정규, 임시, 시간제
주거형태 - 자가,전세,월세,시설거주,기타
주택형태 - 아파트,단독주택,다세대,영구임대,단칸방,기타
-@@ 둘중하나 선택 바람 @@-
동거형태 - 독거,자녀 동거,손자녀 동거,배우자 동거(각방사용,합방),부부-자녀동거,부부-자녀부부 동거,부부-자녀부부-손자녀 동거,
         부부-손자녀동거,친족동거,비혈연동거,기타
         
동거형태 - 독거,배우자 동거,배우자만 동거,아들동거,아들만동거,딸동거,딸만동거,며느리동거,
         며느리만 동거,사위동거,사위만동거,손자녀동거,손자녀만 동거,기타동거인,기타동거인만  

         
내담자와의 관계 - 본인 , 본인 외(배우자,자녀,친인척,이웃,유관기관)
추후상담 - 내방,전화,방문상담
상담신청방법 - 내방, 방문, 면접상담, 전화상담, 온라인상담, 심리검사, 집단상담
                    추가해야되는지 애매함???상담사업 - 대인관계갈등, 사별적응, 성 및 부부갈등, 분노, 우울, 노인학대, 노인자살
상담구분 - 노인상담,중장년층상담

상담 전문학회 및 국가자격 기준 - 상담심리사(한국상담심리학회), 전문상담사(한국상담심리학회), 가족치료사(한국가족치료학회)
                          , 청소년상담사(여성가족부), 임상심리사(한국산업인력공단), 전문상담교사(교육부)
상담방법 - 
개인상담(내방,방문,전화,온라인,기타)
집단상담(사별애도,죽음준비,관계개선의사소통,심리·정서,자아통합,치매예방)
상담진행상태 - 진행,종결,재신청,보류,복귀
                    ??? 상담사 - 운영자,내담자관리,상담내역서,집단상담,보고서 
상담사 - 전체운영자,센터 운영자,전문상담사,실무자,생명사랑지원단,실버보듬이,기타 (상담사 구분)
                    ??? 상담진행현황 - 단회기 상담(1회 종결) - (단순 정보 상담,복지서비스 안내)
지속상담 - 10회기이내,20회기이내,20회기 이상 30회기 미만,30회기 이상

@@ 내부,회부의뢰로 나누지 않고 한번에 분류함 @@
상담경위 - 내부의뢰,외부의뢰( □치매예방 □정신건강복지센터 □노인보호전문기관 □방문간호센터 □무한돌봄센터 □건강가정지원센터 □노인관련기관 □행정기관 □기타 ),
        자발적 신청,발굴( □교육 □캠페인 □홍보),기타
        
종결 - 합의종결,이사,장기입원,사망,시설입소,청력 및 언어장애,치매 및 정신장애,연락두절,내담자의 일방적종결(거부),자살시도
보류 - 장기입원,장기여행,친인척방문,이사,내담자의 연기요청,기타
종결사유 - 합의종결, 이상, 장기입원, 사망, 시설입소, 청력언어장애, 치매 및 정신장애 등, 내담자의 일방적 종결(거부), 연락두절, 자살, 자살시도, 타 기관연계
요청구분 - 가입승인,일지삭제(초기,개별상담,집단상담),프로그램오류,기타 
센터구분 - 전체운영자,센터운영자,전문상담사,생명사랑교육단,실버보듬이,실무자,기타
증빙서류 - 진행사진,계획서,결과보고서


설치장소 - 노인복지관, 종합사회복지관, 노인종합재기센터, 노인재기센터
운영비 - 출장여비, 사무용품 구입비, 홍보비, 강사비, 회의 운영비, 교육비, 프로그램 운영, 공공요금(전용회선 전화요금)
운영기관 - 사례관리팀, 정서생활지원팀
방문요양 - 신체활동, 정서지원, 가사지원, 방문목욕
방문간호 - 건강관리, 기본간호, 신체·질병·인지·영양·배설관리
예방교육 - 치매, 학대, 우울증, 의사소통, 성문제
교육대상 - 노인,일반주민,소속기관,유관기관,기타
작성관리 - 진행일자, 교육대상, 교육인원, 교육주제, 진행사진, 강사명
연계(내부) - 여가,(법률,세무),경제후원,(취업,일자리),(생활,식생활,주거),기타
@@@@@@@@@@@@@@@@@@@@@@@@@@@@@@@@@@@@@@@@@@@@@@@@@@@@@@@@@
외부연계 - 정신보건자살예방센터,노인보호전문기관,보건소방문가호,일자리관련기관,무한돌봄센터긴급지원,법률기관
     (성폭력,가정폭력상담소),치매안심센터,건강가정다문화가정지원센터,행정기관주민센터,기타

심리검사 - DUKE-AD간략우울,GDS-KR노인우울,GDS-SI노인우울자살사고,불안,스트레스,사별스트레스,대인관계변화,부부의사소통,MMSE-K치매선별,기타
상담지원봉사자 - 사후관리-안부확인(방문),사후간리-안부확인(전화),심리검사,연계상담 시 동행,홍보활동,기타
네트워크활동 - 권역네트워크회의,네트워크회의(구.권역장회의),실무회의,기관내부사례회의,지역사회 네트워크회의,기타
행사 - 지역축제, 지역행사, 복지관련 행사
대중매체 - 지역신문, 지역방송, 잡지, 생활정보지, 정기 간행물
홍보 - 행사,방문홍보,대중매체,인터넷,설치물,홍보물품,기타


대인관계 - 종교인교우, 친구·동료·이웃, 사회복지사(요양보호사, 노인돌보미 등) 등과의 대인관 계 어려움
노인과의관계 - 노인본인,배우자,자녀,친인척,이웃,유관기관
심리·정서 - 우울, 불안, 외로움, 상실감, 절망감, 분노(화병),  - 검토가 필요한 항목 우울예방, 긍정성 향상, 마음다루기, 분노조절 -
치매 - 치매염려, 치매증상,(경도인지 장애, 주요인지 장애), 치매 증상악화
중독 - 알코올, 도박, 니코틴, 항정신성약물, SNS 이용관련(게임, 채팅)
정신 - 건강 장애
자살 - 자살생각, 자살의도, 자살계획, 자살시도력, 자살행동, 자살유가족
기타 - 기분장애(우울증, 조울증 등), 불안장애, 인격장애, 조현증 기타 정신적 증상 
건강 - 건강염려, 질환, 건강악화, 입원수술, 시한부, 장애진단 및 판정 등에 따른 어려움 
경제 - 수입감소, 저소득 경제지원 축소탈락, 부채증가, 실직, 자녀경제지원, 재산분배갈등, 세무, 사기·보이스피싱·다단계 등에 따른 어려움
생활 - 거주지 불안정, 일상생활(의식주, 생활환경의 어려움), 외출의 어려움(병원 등 동행 필요)
성 - 이성교제, 재혼, 성기능저하, 성병, 성폭행, 성적 학대
부부 - 가정폭력(가해, 피해), 별거/이혼, 사별고통, 성관계 갈등, 성역할 갈등, 의사소통, 부 부갈등, 외도
가족 - 노인가족학대, 가족의 경제적 학대, 부양기피, 자녀갈등, 시부모와 갈등, 며느리·사위 갈등, 자녀문제(이혼, 실직 등), 손자녀양육 및 갈등
역할상실 - 역할변화, 역할전환, 은퇴, 사회적 소외, 노인차별
생애진로 - 생애진로, 취업
기타 - 노인범죄


   
         
주요문제 - 심리·정서문제,대인관계문제,중독문제,치매문제,정신건강장애문제,건강문제,경제문제,생활문제,
         성문제,부부문제,가족문제,역할상실문제,생애진로문제,기타

주호소문제 - 심리정서,대인관계,치매,중독,정신건강·장애,건강,경제,생활,성,부부,가족,역할상실,생애진로,기타
결혼상태 - 기혼,사별(자연사,질병사,급성질병사,사고사,자살,기타/사별기간 년도),별거(년도),이혼(년도),미혼,재혼(년도),
         동거(년도),비정기적 동거,이성교제,기타
수면상태 - 매우만족,막족,보통,불만족,매우불만족
참여기관 - 소방서,경찰서,시․군․구청,행정복지센터,무한돌봄센터,병·의원,정신건강증진센터,타상담기관,노인관련시설,노인복지관,
         노인보호전문기관,건강가정지원센터,치매안심센터,치매관련기관,노인재가관련기관,독거노인관련기관,노인일자리기관,새마을부녀회,기타(    )          

          
===================================         


배우자와의 친밀도 - 매우높음,높음,보통,낮음,매우낮음
일상생활최근 - 일상생활에 문제없음,외출 시 도움필요,식사나 거동에 도움필요,외상(특이사항:)
최근겅강변화 - 매우 좋아짐,조금 좋아짐,변화없음,조금 나빠짐,급격히 나빠짐
음주 - 거의매일,주2~3회,주1회,월1~2회,연7~8회,연3~4회,거의먹지않음
최근경제변화 - 매우 좋아짐,조금좋아짐,변화없음,조금 나빠짐,매우 나빠짐
부채부담감 - 부채(유,무)
         - 거의 부담없음,부담적음,보통,부담이됨,매우 부담됨
사회 취업여부참여 - 취업 중,퇴직 후,취업한적없음
사회활동여부 - 자원봉사,복지관,노인대학,경로당,동호회,종교관련활등,친목모임,스프츠센터,평생교육,기타
위험성 - SO,S1,S2,S3,S4


  
  
  
    